Gene Name	GermlineJCDR3Part	FR4
TRAJ8	TGAACACAGGCTTTCAGAAACTTGTATTT	GGAACTGGCACCCGACTTCTGGTCAGT
TRAJ7	TGACTATGGGAACAACAGACTCGCTTTT	GGGAAGGGGAACCAAGTGGTGGTCATA
TRAJ6	TGCATCAGGAGGAAGCTACATACCTACATTT	GGAAGAGGAACCAGCCTTATTGTTCAT
TRAJ5	TGGACACGGGCAGGAGAGCACTTACTTTT	GGGAGTGGAACAAGACTCCAAGTGCAA
TRAJ9	GGAAATACTGGAGGCTTCAAAACTATCTTT	GGAGCAGGAACAAGACTATTTGTTAAA
TRAJ4	TGTTTTCTGGTGGCTACAATAAGCTGATTTTT	GGAGCAGGGACCAGGCTGGCTGTACAC
TRAJ3	GGGGTACAGCAGTGCTTCCAAGATAATCTTT	GGATCAGGGACCAGACTCAGCATCCGG
TRAJ2	TGAATACTGGAGGAACAATTGATAAACTCACATTT	GGGAAAGGGACCCATGTATTCATTATA
TRAJ1	GTATGAAAGTATTACCTCCCAGTTGCAATTT	GGCAAAGGAACCAGAGTTTCCACTTCT
TRAJ20	GTTCTAACGACTACAAGCTCAGCTTT	GGAGCCGGAACCACAGTAACTGTAAGA
TRAJ11	TGAATTCAGGATACAGCACCCTCACCTTT	GGGAAGGGGACTATGCTTCTAGTCTCT
TRAJ10	ATACTCACGGGAGGAGGAAACAAACTCACCTTT	GGGACAGGCACTCAGCTAAAAGTGGAA
TRAJ13	TGAATTCTGGGGGTTACCAGAAAGTTACCTTT	GGAATTGGAACAAAGCTCCAAGTCATC
TRAJ12	GGATGGATAGCAGCTATAAATTGATCTTC	GGGAGTGGGACCAGACTGCTGGTCAGG
TRAJ15	CCAACCAGGCAGGAACTGCTCTGATCTTT	GGGAAGGGAACCCACCTATCAGTGAGT
TRAJ14	ATTTATAGCACATTCATCTTT	GGGAGTGGGACAAGATTATCAGTAAAA
TRAJ17	TGATCAAAGCTGCAGGCAACAAGCTAACTTTT	GGAGGAGGAACCAGGGTGCTAGTTAAA
TRAJ16	GGTTTTCAGATGGCCAGAAGCTGCTCTTT	GCAAGGGGAACCATGTTAAAGGTGGAT
TRAJ19	GCTATCAAAGATTTTACAATTTCACCTTT	GGAAAGGGATCCAAACATAATGTCACT
TRAJ18	CCGACAGAGGCTCAACCCTGGGGAGGCTATACTTT	GGAAGAGGAACTCAGTTGACTGTCTGG
TRAJ30	TGAACAGAGATGACAAGATCATCTTT	GGAAAAGGGACACGACTTCATATTCTC
TRAJ31	GGAATAACAATGCCAGACTCATGTTT	GGAGATGGAACTCAGCTGGTGGTGAAG
TRAJ24	TGACAACTGACAGCTGGGGGAAATTGCAGTTT	GGAGCAGGGACCCAGGTTGTGGTCACC
TRAJ23	TGATTTATAACCAGGGAGGAAAGCTTATCTTC	GGACAGGGAACGGAGTTATCTGTGAAA
TRAJ22	TTTCTTCTGGTTCTGCAAGGCAACTGACCTTT	GGATCTGGGACACAATTGACTGTTTTA
TRAJ21	TACAACTTCAACAAATTTTACTTT	GGATCTGGGACCAAACTCAATGTAAAA
TRAJ28	CATACTCTGGGGCTGGGAGTTACCAACTCACTTTC	GGGAAGGGGACCAAACTCTCGGTCATA
TRAJ27	TAACACCAATGCAGGCAAATCAACCTTT	GGGGATGGGACTACGCTCACTGTGAAG
TRAJ26	GGGATAACTATGGTCAGAATTTTGTCTTT	GGTCCCGGAACCAGATTGTCCGTGCTG
TRAJ25	CAGAAGGACAAGGCTTCTCCTTTATCTTT	GGGAAGGGGACAAGGCTGCTTGTCAAG
TRAJ29	GGAATTCAGGAAACACACCTCTTGTCTTT	GGAAAGGGCACAAGACTTTCTGTGATT
TRAJ38	TAATGCTGGCAACAACCGTAAGCTGATTTGG	GGATTGGGAACAAGCCTGGCAGTAAAT
TRAJ39	TGAATAATAATGCAGGCAACATGCTCACCTTT	GGAGGGGGAACAAGGTTAATGGTCAAA
TRAJ36	TCAAACTGGGGCAAACAACCTCTTCTTT	GGGACTGGAACGAGACTCACCGTTATT
TRAJ37	TGGCTCTGGCAACACAGGCAAACTAATCTTT	GGGCAAGGGACAACTTTACAAGTAAAA
TRAJ34	TCTTATAACACCGACAAGCTCATCTTT	GGGACTGGGACCAGATTACAAGTCTTT
TRAJ35	GATAGGCTTTGGGAATGTGCTGCATTGC	GGGTCCGGCACTCAAGTGATTGTTTTA
TRAJ32	TGAATTATGGCGGTGCTACAAACAAGCTCATCTTT	GGAACTGGCACTCTGCTTGCTGTCCAG
TRAJ33	TGGATAGCAACTATCAGTTAATCTGG	GGCGCTGGGACCAAGCTAATTATAAAG
TRAJ42	TGAATTATGGAGGAAGCCAAGGAAATCTCATCTTT	GGAAAAGGCACTAAACTCTCTGTTAAA
TRAJ41	GAACTCAAATTCCGGGTATGCACTCAACTTC	GGCAAAGGCACCTCGCTGTTGGTCACA
TRAJ40	ACTACCTCAGGAACCTACAAATACATCTTT	GGAACAGGCACCAGGCTGAAGGTTTTA
TRAJ47	TGGAATATGGAAACAAACTGGTCTTT	GGCGCAGGAACCATTCTGAGAGTCAAG
TRAJ48	TATCTAACTTTGGAAATGAGAAATTAACCTTT	GGGACTGGAACAAGACTCACCATCATA
TRAJ49	GAACACCGGTAACCAGTTCTATTTT	GGGACAGGGACAAGTTTGACGGTCATT
TRAJ43	ACAATAACAATGACATGCGCTTT	GGAGCAGGGACCAGACTGACAGTAAAA
TRAJ44	TAAATACCGGCACTGCCAGTAAACTCACCTTT	GGGACTGGAACAAGACTTCAGGTCACG
TRAJ45	TGTATTCAGGAGGAGGTGCTGACGGACTCACCTTT	GGCAAAGGGACTCATCTAATCATCCAG
TRAJ46	AGAAGAAAAGCAGCGGAGACAAGCTGACTTTT	GGGACCGGGACTCGTTTAGCAGTTAGG
TRAJ51	AGATGCGTGACAGCTATGAGAAGCTGATATTT	GGAAAGGAGACATGACTAACTGTGAAG
TRAJ50	TGAAAACCTCCTACGACAAGGTGATATTT	GGGCCAGGGACAAGCTTATCAGTCATT
TRAJ53	AGAATAGTGGAGGTAGCAACTATAAACTGACATTT	GGAAAAGGAACTCTCTTAACCGTGAAT
TRAJ52	CTAATGCTGGTGGTACTAGCTATGGAAAGCTGACATTT	GGACAAGGGACCATCTTGACTGTCCAT
TRAJ56	TTATACTGGAGCCAATAGTAAGCTGACATTT	GGAAAAGGAATAACTCTGAGTGTTAGA
TRAJ57	TAACTCAGGGCGGATCTGAAAAGCTGGTCTTT	GGAAAGGGAACGAAACTGACAGTAAAC
TRAJ54	TAATTCAGGGAGCCCAGAAGCTGGTATTT	GGCCAAGGAACCAGGCTGACTATCAAC
TRAJ55	ACAAGTGCTGGTAATGCTCCTGTTG	GGGAAAGGGGATGAGTACAAAAATAAA
TRAJ58	TTTAAGAAACCAGTGGCTCTAGGTTGACCTTT	GGGGAAGGAACACAGCTCACAGTGAAT
TRAJ59	GGAAGGAAGGAAACAGGAAATTTACATTT	GGAATGGGGACGCAAGTGAGA
TRAJ60	TGAAGATCACCTAGATGCTCAACTTT	GGGAAGGGGACTGAGTTAATTGTGAGC
TRAJ61	GGTACCGGGTTAATAGGAAACTGACATTT	GGAGCCAACACTAGAGGAATCATGAAA
